Year,Age,Female,Male,Unknown,Total,Percent
2012,0 to 9,5,1,0,6,8.7
2012,10 to 19,3,1,0,4,5.8
2012,20 to 29,1,6,0,7,10.14
2012,30 to 39,3,0,0,3,4.35
2012,40 to 49,5,3,0,8,11.59
2012,50 to 59,2,9,0,11,15.94
2012,60 to 69,7,3,0,10,14.49
2012,70 to 79,6,8,0,14,20.29
2012,80 to 89,1,3,0,4,5.8
2012,90+,1,1,0,2,2.9
